¿=ﾐ
Ñ=ｰ
ñ=ｯ
ô=ﾔ
ò=ﾒ
Õ=ｵ
Û=ｻ
Ô=ｴ
Î=ｮ
Ê=ｪ
Ì=ｬ
Í=ｭ
Á=｡
É=ｩ
È=ｨ
Â=ｫ
Ç=ｧ
Ò=ｲ
Ó=ｳ
ì=ﾌ
è=ﾈ
Ù=ｹ
Ú=ｺ
ù=ﾙ
â=ﾂ
à=ﾀ
ê=ﾊ
ç=ﾇ
õ=ﾕ
ã=ﾃ
í=ﾍ
á=ﾁ
é=ﾉ
ó=ﾓ
ú=ﾚ
À=ｦ
Ë=ｱ
ë=ｶ
Î=ｷ
î=ｸ
Ï=ｼ
û=ｾ
ü=ｿ
Ü=ﾄ
œ=ﾆ
æ=ﾋ